-1 -1 -1 -1 -1 -1 -1 -1 -1 -1
-1 -1 -1 -1 -1 -1 -1 -1 -1 -1
-1 -1 -1 -1 -1 -1 -1 -1 -1 -1
-1 -1 -1 -1 -1 -1 -1 -1 -1 -1
-1 -1 0 0 -1 -1 0 0 -1 -1
-1 0 0 0 -1 -1 0 0 0 -1
-1 0 5 5 -1 -1 5 5 0 -1
-1 0 5 5 -1 -1 5 5 0 -1
-1 0 5 2 -1 -1 2 5 0 -1
-1 0 5 2 -1 -1 2 5 0 -1
-1 -1 5 2 -1 -1 2 5 -1 -1
-1 -1 -1 -1 8 8 -1 -1 -1 -1
-1 -1 -1 -1 8 8 -1 4 4 -1
-1 -1 -1 -1 -1 -1 -1 4 4 -1
-1 -1 1 -1 -1 -1 4 4 4 -1
-1 -1 1 1 1 1 4 4 4 -1
-1 -1 -1 1 1 1 4 4 -1 -1
-1 -1 -1 -1 -1 -1 -1 -1 -1 -1
-1 -1 -1 -1 -1 -1 -1 -1 -1 -1
-1 -1 -1 -1 -1 -1 -1 -1 -1 -1
-1 -1 -1 -1 -1 -1 -1 -1 -1 -1
-1 -1 -1 -1 -1 -1 -1 -1 -1 -1
-1 -1 -1 -1 -1 -1 -1 -1 -1 -1
-1 -1 -1 -1 -1 -1 -1 -1 -1 -1
-1 -1 -1 -1 -1 -1 -1 -1 -1 -1
-1 -1 -1 -1 -1 -1 -1 -1 -1 -1
