-1 -1 -1 -1 -1 -1 -1 -1 -1 -1
-1 -1 -1 -1 -1 0 -1 -1 -1 -1
-1 -1 -1 -1 -1 3 0 -1 -1 -1
-1 -1 0 -1 -1 5 3 0 -1 -1
-1 0 3 0 -1 2 5 3 0 -1
0 3 5 3 8 8 2 5 3 0
0 -1 -1 -1 -1 -1 -1 -1 -1 0
0 4 1 7 8 8 4 1 4 0
-1 0 4 1 7 -1 0 4 0 -1
-1 -1 0 4 1 -1 -1 0 -1 -1
-1 -1 -1 0 4 -1 -1 -1 -1 -1
-1 -1 -1 -1 0 -1 -1 -1 -1 -1
-1 -1 -1 -1 -1 -1 -1 -1 -1 -1
-1 -1 -1 -1 -1 -1 -1 -1 -1 -1
-1 -1 -1 -1 -1 -1 -1 -1 -1 -1
-1 -1 -1 -1 -1 -1 -1 -1 -1 -1
-1 -1 -1 -1 -1 -1 -1 -1 -1 -1
-1 -1 -1 -1 -1 -1 -1 -1 -1 -1
-1 -1 -1 -1 -1 -1 -1 -1 -1 -1
-1 -1 -1 -1 -1 -1 -1 -1 -1 -1
-1 -1 -1 -1 -1 -1 -1 -1 -1 -1
-1 -1 -1 -1 -1 -1 -1 -1 -1 -1
-1 -1 -1 -1 -1 -1 -1 -1 -1 -1
-1 -1 -1 -1 -1 -1 -1 -1 -1 -1
-1 -1 -1 -1 -1 -1 -1 -1 -1 -1
-1 -1 -1 -1 -1 -1 -1 -1 -1 -1
