4 1 1 7 8 8 7 1 1 4
-1 -1 -1 -1 8 8 -1 -1 -1 -1
-1 -1 -1 -1 8 8 -1 -1 -1 -1
-1 -1 -1 -1 8 8 -1 -1 -1 -1
-1 -1 -1 -1 8 8 -1 -1 -1 -1
-1 -1 -1 -1 8 8 -1 -1 -1 -1
-1 -1 -1 -1 8 8 -1 -1 -1 -1
-1 -1 -1 -1 8 8 -1 -1 -1 -1
-1 -1 -1 -1 8 8 -1 -1 -1 -1
-1 -1 -1 -1 8 8 -1 -1 -1 -1
-1 -1 -1 -1 8 8 -1 -1 -1 -1
-1 -1 -1 -1 8 8 -1 -1 -1 -1
-1 -1 -1 -1 8 8 -1 -1 -1 -1
-1 -1 -1 -1 8 8 -1 -1 -1 -1
-1 -1 -1 -1 8 8 -1 -1 -1 -1
-1 -1 -1 -1 8 8 -1 -1 -1 -1
-1 -1 -1 -1 -1 -1 -1 -1 -1 -1
-1 -1 -1 -1 -1 -1 -1 -1 -1 -1
-1 -1 -1 -1 -1 -1 -1 -1 -1 -1
-1 -1 -1 -1 -1 -1 -1 -1 -1 -1
-1 -1 -1 -1 -1 -1 -1 -1 -1 -1
-1 -1 -1 -1 -1 -1 -1 -1 -1 -1
-1 -1 -1 -1 -1 -1 -1 -1 -1 -1
-1 -1 -1 -1 -1 -1 -1 -1 -1 -1
-1 -1 -1 -1 -1 -1 -1 -1 -1 -1
-1 -1 -1 -1 -1 -1 -1 -1 -1 -1
