-1 -1 -1 -1 -1 -1 -1 -1 -1 -1
0 -1 -1 -1 -1 -1 -1 -1 -1 0
-1 0 -1 0 -1 -1 0 -1 0 -1
-1 -1 0 -1 0 0 -1 0 -1 -1
-1 -1 -1 4 6 6 4 -1 -1 -1
-1 3 7 -1 -1 -1 -1 7 3 -1
-1 3 -1 -1 1 1 -1 -1 3 -1
-1 3 7 -1 -1 -1 -1 7 3 -1
-1 -1 -1 4 6 6 4 -1 -1 -1
-1 -1 2 -1 2 2 -1 2 -1 -1
0 0 0 0 -1 -1 -1 0 0 0
-1 -1 -1 -1 -1 -1 -1 -1 -1 -1
-1 -1 -1 -1 -1 -1 -1 -1 -1 -1
-1 -1 -1 -1 -1 -1 -1 -1 -1 -1
-1 -1 -1 -1 -1 -1 -1 -1 -1 -1
-1 -1 -1 -1 -1 -1 -1 -1 -1 -1
-1 -1 -1 -1 -1 -1 -1 -1 -1 -1
-1 -1 -1 -1 -1 -1 -1 -1 -1 -1
-1 -1 -1 -1 -1 -1 -1 -1 -1 -1
-1 -1 -1 -1 -1 -1 -1 -1 -1 -1
-1 -1 -1 -1 -1 -1 -1 -1 -1 -1
-1 -1 -1 -1 -1 -1 -1 -1 -1 -1
-1 -1 -1 -1 -1 -1 -1 -1 -1 -1
-1 -1 -1 -1 -1 -1 -1 -1 -1 -1
-1 -1 -1 -1 -1 -1 -1 -1 -1 -1
-1 -1 -1 -1 -1 -1 -1 -1 -1 -1
