-1 -1 -1 -1 -1 -1 -1 -1 -1 -1
-1 -1 -1 -1 -1 -1 -1 -1 -1 -1
-1 -1 -1 -1 -1 -1 -1 -1 -1 -1
-1 -1 -1 -1 -1 -1 -1 -1 -1 -1
-1 -1 -1 -1 5 5 -1 -1 -1 -1
-1 -1 -1 -1 5 5 -1 -1 -1 -1
-1 -1 -1 -1 3 3 -1 -1 -1 -1
-1 -1 -1 -1 3 3 -1 -1 -1 -1
-1 -1 -1 -1 7 7 -1 -1 -1 -1
8 -1 8 -1 7 7 -1 8 -1 8
-1 8 -1 8 -1 -1 8 -1 8 -1
8 -1 8 -1 -1 -1 -1 8 -1 8
-1 8 -1 8 -1 -1 8 -1 8 -1
8 -1 8 -1 -1 -1 -1 8 -1 8
-1 -1 -1 -1 -1 -1 -1 -1 -1 -1
-1 -1 -1 -1 -1 -1 -1 -1 -1 -1
-1 -1 -1 -1 -1 -1 -1 -1 -1 -1
-1 -1 -1 -1 -1 -1 -1 -1 -1 -1
-1 -1 -1 -1 -1 -1 -1 -1 -1 -1
-1 -1 -1 -1 -1 -1 -1 -1 -1 -1
-1 -1 -1 -1 -1 -1 -1 -1 -1 -1
-1 -1 -1 -1 -1 -1 -1 -1 -1 -1
-1 -1 -1 -1 -1 -1 -1 -1 -1 -1
-1 -1 -1 -1 -1 -1 -1 -1 -1 -1
-1 -1 -1 -1 -1 -1 -1 -1 -1 -1
-1 -1 -1 -1 -1 -1 -1 -1 -1 -1
