-1 -1 -1 -1 -1 -1 -1 -1 -1 -1
-1 -1 -1 -1 -1 -1 -1 -1 -1 -1
-1 -1 -1 -1 -1 -1 -1 -1 -1 -1
-1 -1 8 -1 -1 -1 -1 8 -1 -1
-1 -1 8 -1 -1 -1 -1 8 -1 -1
-1 -1 5 -1 -1 -1 -1 1 -1 -1
-1 -1 5 -1 -1 -1 -1 1 -1 -1
-1 8 5 8 -1 -1 8 1 8 -1
-1 8 -1 8 -1 -1 8 -1 8 -1
-1 2 -1 3 -1 -1 7 -1 4 -1
-1 2 -1 3 -1 -1 7 -1 4 -1
8 2 -1 3 8 8 7 -1 4 8
8 -1 -1 -1 8 8 -1 -1 -1 8
0 -1 -1 -1 6 0 -1 -1 -1 6
0 -1 -1 -1 6 0 -1 -1 -1 6
0 -1 -1 -1 6 0 -1 -1 -1 6
-1 -1 -1 -1 -1 -1 -1 -1 -1 -1
-1 -1 -1 -1 -1 -1 -1 -1 -1 -1
-1 -1 -1 -1 -1 -1 -1 -1 -1 -1
-1 -1 -1 -1 -1 -1 -1 -1 -1 -1
-1 -1 -1 -1 -1 -1 -1 -1 -1 -1
-1 -1 -1 -1 -1 -1 -1 -1 -1 -1
-1 -1 -1 -1 -1 -1 -1 -1 -1 -1
-1 -1 -1 -1 -1 -1 -1 -1 -1 -1
-1 -1 -1 -1 -1 -1 -1 -1 -1 -1
-1 -1 -1 -1 -1 -1 -1 -1 -1 -1
