-1 0 5 0 5 4 4 4 4 -1
-1 5 0 5 0 0 0 0 0 -1
-1 0 5 0 5 4 4 4 4 -1
-1 5 0 5 0 0 0 0 0 -1
-1 4 4 4 4 4 4 4 4 -1
-1 0 0 0 0 0 0 0 0 -1
-1 4 4 4 4 4 4 4 4 -1
-1 9 9 -1 9 9 9 9 9 -1
-1 9 9 -1 9 9 9 9 9 -1
-1 9 9 -1 9 9 -1 -1 -1 -1
-1 9 9 -1 9 9 -1 -1 -1 -1
-1 9 9 9 9 9 9 9 9 -1
-1 9 9 9 9 9 9 9 9 -1
-1 -1 -1 -1 9 9 -1 9 9 -1
-1 -1 -1 -1 9 9 -1 9 9 -1
-1 9 9 9 9 9 -1 9 9 -1
-1 9 9 9 9 9 -1 9 9 -1
-1 -1 -1 -1 -1 -1 -1 -1 -1 -1
-1 -1 -1 -1 -1 -1 -1 -1 -1 -1
-1 -1 -1 -1 -1 -1 -1 -1 -1 -1
-1 -1 -1 -1 -1 -1 -1 -1 -1 -1
-1 -1 -1 -1 -1 -1 -1 -1 -1 -1
-1 -1 -1 -1 -1 -1 -1 -1 -1 -1
-1 -1 -1 -1 -1 -1 -1 -1 -1 -1
-1 -1 -1 -1 -1 -1 -1 -1 -1 -1
-1 -1 -1 -1 -1 -1 -1 -1 -1 -1
