-1 -1 -1 -1 -1 -1 -1 -1 -1 -1
-1 -1 -1 -1 -1 -1 -1 -1 -1 -1
-1 -1 -1 -1 9 9 -1 -1 -1 -1
5 5 -1 -1 -1 -1 -1 -1 5 5
5 5 -1 -1 -1 -1 -1 -1 5 5
5 5 -1 -1 5 5 -1 -1 5 5
6 6 -1 -1 6 6 -1 -1 6 6
-1 -1 -1 -1 6 6 -1 -1 -1 -1
-1 -1 -1 -1 -1 -1 -1 -1 -1 -1
-1 -1 -1 -1 -1 -1 -1 -1 -1 -1
-1 -1 -1 -1 0 0 -1 -1 -1 -1
-1 7 -1 -1 0 0 -1 -1 7 -1
-1 7 -1 -1 7 7 -1 -1 7 -1
-1 7 -1 -1 -1 -1 -1 -1 7 -1
-1 9 -1 -1 -1 -1 -1 -1 9 -1
-1 -1 -1 -1 -1 -1 -1 -1 -1 -1
-1 -1 -1 -1 -1 -1 -1 -1 -1 -1
-1 -1 -1 -1 -1 -1 -1 -1 -1 -1
-1 -1 -1 -1 -1 -1 -1 -1 -1 -1
-1 -1 -1 -1 -1 -1 -1 -1 -1 -1
-1 -1 -1 -1 -1 -1 -1 -1 -1 -1
-1 -1 -1 -1 -1 -1 -1 -1 -1 -1
-1 -1 -1 -1 -1 -1 -1 -1 -1 -1
-1 -1 -1 -1 -1 -1 -1 -1 -1 -1
-1 -1 -1 -1 -1 -1 -1 -1 -1 -1
-1 -1 -1 -1 -1 -1 -1 -1 -1 -1
