-1 -1 -1 -1 -1 -1 -1 -1 -1 -1
-1 -1 -1 -1 -1 -1 -1 -1 -1 -1
-1 0 3 3 3 3 3 3 3 3
-1 0 -1 3 3 3 3 3 3 3
-1 0 -1 2 -1 -1 2 -1 -1 -1
-1 0 -1 2 -1 -1 2 -1 -1 -1
-1 0 -1 2 2 2 2 -1 -1 -1
-1 -1 -1 -1 -1 -1 -1 -1 -1 -1
-1 -1 -1 1 1 1 1 -1 0 -1
-1 -1 -1 1 -1 -1 1 -1 0 -1
-1 -1 -1 1 -1 -1 1 -1 0 -1
6 6 6 6 6 6 6 -1 0 -1
6 6 6 6 6 6 6 6 0 -1
-1 -1 -1 -1 -1 -1 -1 -1 -1 -1
-1 -1 -1 -1 -1 -1 -1 -1 -1 -1
-1 -1 9 9 9 9 9 9 -1 -1
-1 -1 -1 -1 -1 -1 -1 -1 -1 -1
-1 -1 -1 -1 -1 -1 -1 -1 -1 -1
-1 -1 -1 -1 -1 -1 -1 -1 -1 -1
-1 -1 -1 -1 -1 -1 -1 -1 -1 -1
-1 -1 -1 -1 -1 -1 -1 -1 -1 -1
-1 -1 -1 -1 -1 -1 -1 -1 -1 -1
-1 -1 -1 -1 -1 -1 -1 -1 -1 -1
-1 -1 -1 -1 -1 -1 -1 -1 -1 -1
-1 -1 -1 -1 -1 -1 -1 -1 -1 -1
-1 -1 -1 -1 -1 -1 -1 -1 -1 -1
